 |      | || |||
|              |
 |   ||| |||   |
|  ||| | | |||  
 | | | | | | | |
|  ||||| ||||| |
|       |       
 |     ||      |
 |     |        
|     |||       
|               
 |  |||||||||   
 |  | | | | |   
|               
|             ||
||| || |      | 